[layer]
type=Tile Layer 1
data=
1,1,1,1,1,1,1,1,1,1,1,
1,1,1,1,1,1,1,1,1,1,1,
1,1,1,1,1,1,1,1,1,1,1,
1,1,1,1,1,1,1,1,1,1,1,
1,1,1,1,1,1,1,1,1,1,1,
1,1,1,1,1,1,1,1,1,1,1,
1,1,1,1,1,1,1,1,1,1,1,
1,1,1,1,1,1,1,1,1,1,1,
1,1,1,1,1,1,1,1,1,1,1,
1,1,1,1,1,1,1,1,1,1,1,
1,1,1,1,1,1,1,1,1,1,1.
[layer]
type=Tile Layer 2
data=
30,30,30,30,30,50,30,30,30,30,30,
20,0,0,0,0,0,0,0,0,0,20,
20,0,0,0,20,10,20,0,0,0,20,
20,0,50,0,20,0,20,0,50,0,20,
30,50,50,20,0,10,0,20,50,50,30,
50,50,20,0,20,0,20,0,20,50,50,
1,15,15,15,15,50,15,15,15,15,0,
0,0,0,0,0,0,0,0,0,0,0,
0,0,0,0,0,0,0,0,0,0,0,
0,0,0,0,0,0,0,0,0,0,0,
0,0,0,0,0,0,0,0,0,0,0.
