[layer]
type=Tile Layer 1
data=
21,21,21,21,1,21,7,21,21,21,21,
21,21,21,1,1,21,1,1,21,21,21,
21,21,1,0,0,0,0,0,1,21,21,
21,1,0,21,1,6,1,21,0,1,21,
1,0,21,1,1,1,1,1,21,0,1,
1,21,1,1,0,0,0,1,1,21,1,
0,0,0,0,1,0,1,0,0,0,0,
0,0,0,0,1,1,1,0,0,0,0,
0,0,0,0,0,0,0,0,0,0,0,
0,0,0,0,0,0,0,0,0,0,0,
0,0,0,0,0,0,0,0,0,0,0.
[layer]
type=Tile Layer 2
data=
0,0,0,0,10,0,10,0,0,0,0,
0,0,0,10,10,0,10,10,0,0,0,
0,0,10,0,0,0,0,0,10,0,0,
0,10,0,0,10,10,10,0,0,10,0,
10,0,0,10,10,10,10,10,0,0,10,
10,0,10,10,0,0,0,10,10,0,10,
0,0,0,0,25,0,25,0,0,0,0,
0,0,0,0,25,25,25,0,0,0,0,
0,0,0,0,0,0,0,0,0,0,0,
0,0,0,0,0,0,0,0,0,0,0,
0,0,0,0,0,0,0,0,0,0,0.
